########################################
#......................................#
#......................................#
#......................................#
#.................#####................#
#................#K...T................#
#...............####..#................#
#..............#.B...##................#
#..............#.#S#B.#........####....#
#..............#...B..#........#S.#....#
#................#BB#.#........#B.###..#
#................#SSSS#........#SSSS#..#
#..................###.......###.##S####
#.........R..................#S.B.SBS..#
#................#.#.........#S#.##S.###
#................#.#.........#S#....##.#
#..............###.###..##....#S..####..#
#..........A...#..#..#.###...###S#.....#
#..........A.###.###.###T.......S#.....#
#...K......A....##>##.SSSSSS.###S##....#
#.............##.###.########.#.S.###..#
#..............#..#..#........#P.SDK#..#
#..............###.###...B....#PP.###..#
#................#.#..........#####....#
#.................K....................#
#......................................#
#......................................#
#.......#.#.......U....................#
#......##.##...........................#
#...#A#~~~~~#..........................#
#...#A#~~~~~#..........................#
#...#A#~~~~~#..........................#
#...#A#~~~~~#..........................#
#...#A#~~~~~#..........................#
#...#A#~~~~~#..........................#
#...#A#~~~~~#..........................#
#...#A#.....#..........................#
#..#..BB....######.....................#
#..#..#..........K#....................#
########################################