########################################
#...........#~~...U...~~#..............#
#...........#~.........~#..............#
#...........#...A...A...#..............#
#...........T....S.S....#..............#
#...........#....S.S....#..............#
#...........#...A...A...#..............#
#...........T~.........~#..............#
#...........#~~.......~~#......###.....#
#...........####AAAAA####......#S#.....#
#..............#LLLLL#.........#.####..#
#..............#.....#.........#SSSS#..#
#..............##...##.......###S##S####
#...............##.##........#SSB.SBS..#
#................#.#.........#S#.##S.###
#................#.#.....#####S#.B..##.#
#..............###.###..##...#SS...A##..#
#..............#..#..#.###...###S##A#..#
################.###.###T.......S##A#..#
#....#..........##>##.SSSSSS.###S##A#..#
####...####A####.###.##########.S...##.#
#.........#A#..#..#..#.#.##.#.#P.S###..#
#.........#A#..###.###...##...#PP.DK#..#
#....R....#K#....#.#..........#######..#
#.........#.#....#.#######..............#
#####.#####A#...##.#.....#.............#
#.........#A#...#....##A##.............#
#.........#A#...#~~~#....#.............#
#..R...R..#A#...#~~~#..K.###############
#.........#A#...#~~~#.....S.S.S.S.S.S..#
#####.#####A#...#...#.#############.####
#.........#A#...#~~~#..........#~~~~~~~#
#.........#A#...#~~~############~~~~~~~#
#..R.A.R..#A#...#..SS~~~~~~~SS.#~~~S~~~#
#..S...S..#A#...#####.A...A.##.#~~~~~~~#
#..A.S.A..#A#........#.#.#.#.#.#~~~~~~~#
#..R.S.R..#A#........#.#.#.#.#.#~~...~~#
#....S...~~S#........#H#.#H#T..........#
#R......R~~S#........###.####H....H.H..#
########################################