########################################
#......................................#
#......................................#
#......................................#
#.................#####................#
#................#K...T................#
#...............####..#................#
#..............#.B...##................#
#..............#.#S#B.#................#
#..............#...B..#................#
#................#BB#.#................#
#................#SSSS#................#
#..................###.................#
#................................H.....#
#................#.#...................#
#................#.#...................#
#..............###.###..T..............#
#..........A...#..#..#T................#
#..........A.###.###.##.T...........P..#
#...K......A....##>##..SS.SS........P..#
#.............##.###.##................#
#..............#..#..#.................#
#..............###.###...B..B..........#
#................#.#...................#
#.................K....................#
#......................................#
#......................................#
#.......#.#.......H....................#
#......##.##...........................#
#...#.#~~~~~#..........................#
#...#.#~~~~~#..........................#
#...#.#~~~~~#..........................#
#...#.#~~~~~#..........................#
#...#.#~~~~~#..........................#
#...#.#~~~~~#..........................#
#...#.#~~~~~#..........................#
#...#.#.....#..........................#
#..#..BB....######.....................#
#..#..#..........K#....................#
########################################