########################################
#......................................#
#......................................#
#......................................#
#......................................#
#......................................#
#......................................#
#......................................#
#......................................#
#......................................#
#......................................#
#......................................#
#......................................#
#......................................#
#......................................#
#................#.#...................#
#..............###.###.................#
#............T.#.....#.................#
#.............##.....##................#
#.................>....SS.SS...........#
#.............##.....##................#
#..............#.....#.................#
#..............###.###.................#
#................#.#...................#
#.................K....................#
#......................................#
#......................................#
#......................................#
#......................................#
#......................................#
#......................................#
#......................................#
#......................................#
#......................................#
#......................................#
#......................................#
#......................................#
#......................................#
#......................................#
########################################